NO ./textures/exit.xpm
SO ./textures/chest.xpm
WE ./textures/slime.xpm
EA ./textures/wall.xpm

C 125,       230, 50
F 124,23,14

1111
1W01
1001
10E1
1111
