NO ./textures/exit.xpm
SO ./textures/chest.xpm
WE ./textures/slime.xpm
EA ./textures/wall.xpm

C 125, 230, 4
F 124, 23, 14

                                                                    111111
                                                                    100001
                                                                    111111
1111111111111111111111111
1000000000110000000000001
1011000001110000000000001
1001000000000000000000001
111111111011000001110000011
100000000011000001110111111111111111111
1111000000000000000000001000000001
1111011111000000000000001000111100111111
1100000010000001000000001000111111111111
100000010000001 1N000000010001
10000000000000010000010010001
11000000000000111110111100111
1111011111111101 101111010001
11111110 111 111 111111111111
11111111 111 111 111111111111
                                1111111
                                1000001
                                1111111
