   NO             textures/test/north.xpm
SO                                    textures/test/south.xpm
C      1 25, 230,                    4
            WE textures/test/west.xpm
EA textures/test/east.xpm






F 124,         23,                                14





111111111111111111111111111111111111111111111
100000000000000000000000000000000000000000001
100000000000000000000000000000000000000000001
100000000000000000000000000000000000000000001
100000000000000000000000000000000000000000001
100000000000000000000000000000000000000000001
100000000000000000000000000000000000000000001
100000000000000000000000000000000000000000001
100000000000000000000000000000000000000000001
100000000000000000000000000000000000000000001
100000000000000000000000000000000000000000001
100000000000000000000000000000000000000000001
10000000000000000111111111111111111111111111
100000000000000001
10000000000000011
100000001111111
111000000000011111111111111111111
   100000000000000S00000000000001
   10000000000000000000111111111
   11111111111111111111