NO textures/test/north.xpm
SO textures/test/south.xpm
WE textures/test/west.xpm
EA textures/test/east.xpm

C 125, 230, 4
F 124, 23, 14

                                                        111111
                                                        1000001
                                                     1111000000111
                                                    100011110000001
                                                   10000000000000001
                                                  1000000000000000001
111111111111111111111111111111111111111111111    100000001000111100001
100000000000000000000000011111000000111000001   100001111 1000001000001
100001100000000000011100000000000000000000001  100001     10000110000001
100010000000000000000100000010000001000000001110000001     100000000001
100011110000011100000100000111000001000000000000000000111111100000000001
100010000000010000000000000010000001000000001110000000000000000100000001
100010000000111100000000000000011111111111111  10011111100000001111000001
100000000000000111000000000000000000000100001   100000000111111100000001
100000000000000000000001100000000110000100001    1000000000000000000001
101000011111111110000001100000000010000111001     11111111111110000001
101110001000000010011000000110000010000000001                 11111111
101010001000111110011000000110000000000000001
10001000110010000111111111111111111111111111
10111110000011001
10010010000000011                               1
101000101111111                                101
11100000111001111111111111111111111111111111111101
   10010000000000000000000000000000000000000000001
   10011101000000000000111111111111110001111111111
   11111S01111111111111             10000000001
      1001                          1001111001
       101                          1000000001
       1001                         1111111111
       1111
                11111111111
                10001000001
                10011000000111111111111
                10001000000000000000001
                10000000000000000100001
                10110000011111000100001
                10000000000001000111101
                10001100000001000000101
                10000100000000000000001
                10000100000000000000001
                11111111111111111111111
