NO ./textures/test/north.xpm
SO ./textures/test/south.xpm
WE ./textures/test/west.xpm
EA ./textures/test/east.xpm

C 125,  230,       4
        F            124        ,23,14

1111
1001
1001
1E01
1111
