1111111111111111111
1000000100010000001
1000000100010000001
1000000110110000001
1000000000000000001
100N000000000000001
1000000000000000001
1111111111111111111