NO ./textures/test/north.xpm
SO ./textures/test/south.xpm
WE ./textures/test/west.xpm
EA ./textures/test/east.xpm


F 20,20,20
C 200,200,200

1111111
1000001
1000001
1000001
1000001
1000111
10001
10001
1000101
10000S1
1000001
1000001
1000001
1111111
