      1111111111111
1111111000000000001
1000000000000000001
1000000110000000001
1000000110000000001
1000000000000001001
1000000000000001001
1000000000000000001
1000000000000000001
1000000000000000001
1000000110000000001
1000000110000000001
100N000000000001001
1000000000000001001
1111111111111111111