NO ./texture/eagle.xpm
SO ./texture/greystone.xpm
WE ./texture/purplestone.xpm
EA ./texture/red.xpm
F 220,100,0
C 255,200, 10

1111111111111111111
1000000000000000001
1000000000000000001
1000000000011111111
1000010000000000001
1000000000000000001
1000000000000000001
1000011111100000001
1111110000000000001
1000000000000000001
100000000N000000001
1000000000000000001
1111111111111111111