NO ./texture/texture1
SO ./texture/texture2
WE ./texture/texture3
EA ./texture/texture4
F 220,100,0
C 225,30,0

1111111111111111111
1000000000000000001
1000000000000000001
1000000000011111111
1000000000000000001
1000010000000000001
1000010000000000001
1000010000000000001
1111110000000000001
1000000000000N00001
1000000000000000001
1000000000000000001
1111111111111111111