NO                  ./textures/brick.xpm
SO ./textures/knight.xpm
WE ./textures/SKY1.xpm
F                               220,100,0




C 255,0,0
EA ./textures/banner.xpm




1111111111111111111111111111
100000000000000000000011111111111111111111111
10110000011100000000000110000000000000000001
10010000000000000000000001111111111111111111
11111111101100001110000000000001
100000000011000001110111111111111111
11100000000000000000000000010001
110000000000000000000000001
1100000000000000000000000001
10000000000000001100000010001
10000000000000001101010010001111111111111111111111111
1100000000000000000000000N0111
11110111 0110101 101111010001
11111111 1111111 111111111111