NO                  ./texture/texture1
SO ./texture/texture3
WE ./texture/texture2
F                               220,100,0




C 225,30,0
EA ./texture/texture4




1111111111111111111111111
1000000000110000000000001
1011000001110000000000001
1001000000000000000000001
1111111110110000011100000000                00001
100000000011000001110111111111111
11110111111111011100000010001
11110111111111011101010010001
11000000110101011100000010001
1000000000000N001100000000001
10000000000000001101010010001
11000001110101011111011100111
11110111 1110101 101111010001
11111111 1111111 111111111111