NO                  ./textures/brick.xpm
SO ./textures/knight.xpm
WE ./textures/SKY1.xpm
F                               220,100,0




C 255,0,0
EA ./textures/banner.xpm




1111111111111111111111111
1000000000110000000000001
101100000111000000000001
100100000000000000000000011111111
11111111101100001110000000000001
100000000011000001110111111111111
11110111111111011100000010001
11110111111111011101010010001
1100000011010101110000000001
10000000000000001100000010001
10000000000000001101010010001
1100000111010101111101111N0111
11110111 0110101 101111010001
11111111 1111111 111111111111