NO                  ./texture/texture1
SO ./texture/texture3
WE ./texture/texture2
F                               220,100,0




C 225,30,0
EA ./texture/texture4




1111111111111111111111111
1000000000110000000000001
101100000111000000000001
100100000000000000000000011111111
111111111011000001110000000000001
100000000011000001110111111111111
11110111111111011100000010001
11110111111111011101010010001
11000000110101011100000010001
10000000000000001100000010001
10000000000000001101010010001
11000001110101011111011110N0111
11110111 0110101 101111010001
11111111 1111111 111111111111