NO                  ./textures/brick.xpm
SO ./textures/knight.xpm
WE ./textures/SKY1.xpm
F                               220,100,0




C 255,0,0
EA ./textures/banner.xpm




1111111111111111111111111111
10000000001100000000000011111111111111111111
1011000001110000000000011
10010000000000000000000001111111
11111111101100001110000000000001
100000000011000001110111111111111111
111101111111110111000000100001
11110111111111011101010010001
1100000011010101110000000001
10000000000000001100000010001
10000000000000001101010010001
1100000111010101111101111N0111
11110111 0110101 101111010001
11111111 1111111 111111111111