NO ./texture/greystone.xpm
SO ./texture/leafs.xpm
WE ./texture/rough_stone_tiles_resize.xpm
EA ./texture/eagle.xpm
C 225,30,0
F  220,100,0

11111111111111111111111111111111111111111111111111
10000000000000000000000000000000000000000000000001
10000000000000000000000000000000000000000000000001
10000000000000000000000000000000000000000000000001
10000000000000000000000000000000000000000000000001
10000000000000000000000000000000000000000000000001
1000000000000000000000000N000000000000000000000001
10000000000000000000000000000000000000000000000001
10000000000000000000000000000000000000000000000001
11111111111111111111111111111111111111111111111111