NO                  ./textures/brick.xpm


WE  ./textures/knight.xpm
SO ./textures/SKY1.xpm
F                               220,100,0




C 255,128,114
EA ./textures/banner.xpm


1111111111111111111
1000000000000000001
1000000000000000111111
1000000000000000001
1000000000000000111
1N00000100000100001
1111111 11111 11111
