NO ./texture/text_tex.xpm
SO ./texture/text_tex.xpm
WE ./texture/text_tex.xpm
EA ./texture/text_tex.xpm
F 220,100,0
C 135,206,235

1111111111111111111
1000000000000000001
1000000000000000001
1000000000011111111
1000010000000000001
1000000000000000001
1000000000000000001
1000000000000000001
1000000000000000001
1000000000000000001
1000000000000000001
1000000000000000001
1000000000000000001
1000000000000000001
1000000000000000001
1000000000000000001
1000000000000000001
1000000000000000001
1000000000000000001
1000000000000000001
1000000000000000001
1000000000000000001
1000000000000000001
1000000000000000001
1000000000000000001
1000000000000000001
1000000000000000001
1000000000000000001
1000000000000000001
1000011111100000001
1111110000000000001
10W0000000000000001
1000000000000000001
1000000000000000001
1111111111111111111
