NO                  ./textures/brick.xpm
SO ./textures/knight.xpm
WE ./textures/SKY1.xpm
F                               220,100,0




C 255,0,0
EA ./textures/simonkraft/bookshelf_01.xpm









1111111111111111111
100000000000000000111111
100000000000000011111111111111
10000000N0000000000011100000001
1000000000000000111111111111111
100000000000000000111111111111111111111
1111111111111111111
