NO                  ./textures/brick.xpm


WE  ./textures/knight.xpm
SO ./textures/SKY1.xpm
F                               220,100,0

             

                                          
C 255,0,0
EA ./textures/simonkraft/bookshelf_01.xpm






111111111111 111111111
10000000000000000000001
10000000000000000000001
1111111111111111111111111
100000000000000000000001
100000S0000000000000011
100000000000000000000111111111111
100000000000000000011
11111111111111   11