NO                  ./textures/brick.xpm


WE  ./textures/knight.xpm
SO ./textures/SKY1.xpm
F                               220,100,0

             

                                          
C 255,0,0
EA ./textures/simonkraft/bookshelf_01.xpm


1111
1001
1001
1001
1001
1S01
1001
1001
1001
1001
1001
1001
1111