SO ./texture/text_tex.xpm
F 220,100,0
WE ./texture/text_tex.xpm
EA ./texture/test.xm
C 135,206,235

NO ./texture/text_tex.xpm

1111111111111111111
1000000000000000001
1000000000000000111
1000000000000001
1000000000000000111
1N00000000000000001
1111111111111111111

