NO                  ./textures/brick.xpm
SO ./textures/knight.xpm
WE ./textures/SKY1.xpm
F                               220,100,0




C 255,0,0
EA ./textures/simonkraft/bookshelf_01.xpm









111111111111111111
100000000000000001
10000111100000001111111
10000100100000000111
1000010001000N000001
100001111100000001
111111111111111111
