NO                  ./textures/knight.xpm


WE  ./textures/netherrack.xpm
SO ./textures/brick.xpm
F                               220,100,0

             

                                          
C 255,0,0
EA ./textures/soul_sand.xpm






111111111
1000000011
1000E000011
100000001
100000001
111111111