NO                  ./textures/brick.xpm


WE  ./textures/knight.xpm
SO ./textures/SKY1.xpm
F                               220,100,0

             

                                          
C 255,0,0
EA ./textures/simonkraft/bookshelf_01.xpm






1       111  1111111 111111111
111111000S00000000000000001
    10000000        000000000000001
1111111111111111111111111
100000000000000000000001
10000000000000000000011
1000000000000000000001
100000000000000000011
11111111111111   111111111111111